놓 써요	놓아요
놓에요	놓아요
각뿔라고	각뿔이라고
나타낸에요	나타낸거에요
나타낸답에요	나타낸거에요
예 세로까요	예를 들어볼까요
이이에요	이에요
나타내봐볼게요	나타내볼게요
로쳐요	로 만들어요
하하면	하면
않 않	않
않않	않
뜻이에봐요	뜻이에요
뜻이에볼까요	뜻이에요
대합니다	의미합니다
받게아요	받게 되었어요
받게 합니다	받게 됩니다
푼까요	풀어요
푼 써요	풀어요
푼써요	풀어요
푼아요	풀어요
푼 볼까요	풀어볼까요
같은 같아요	같아요
대각각선	대각선
삼형	삼각형
활용 활용	활용
다음 다음	다음
이이죠	이죠
같아보세요	같아요
는는	는
는 는	는
길이일습니다	길이라고 하면
찾아보게요	찾아볼게요
이항를	이항을
일정 일정	일정
나타낸입니다	나타낸 것 입니다
쉽요	쉬워요
꼴꼴	꼴
작요	작아요
작세요	작아요
반복 반복	반복
성립립	성립
9 9 9	9
9 9	9
갖쳐요	가져요
갖세요	가져요
되는되는	되는
되는되는되는	되는
사실이아요	사실이에요
있는아요	있어요
과과	과
세 세	세
결과 같아요	결과를 말해요
모두세요	모두 찾아봐요
하니다	합니다
하고고	하고
뿐어요	뿐이에요
받게습니다	받게 되었습니다
써세요	써보세요
법칙칙	법칙
있는에요	있는 사실이에요
<arrw>	 
<UNK>	 
되는지지보고	되는지 보고
되는지지되면	되는지 보고
모두세요	모두 찾아보세요
했다 돼요	했어요
는의	는
좌변변	좌변
우변변	우변
측정 측정	측정
닮음을해서	닮음을 이용해서
예 다음	예는 다음
말?	말해요
내접수는	내접원이란
쓴 찾아요	써요
있다에요	있어요
,에	 
길이가을	길이가 같을
평면도형이을	평면도형이 이를
완전제곱식 치고	완전제곱식으로 고치고
하고고	하고
뿐어요	뿐이에요
편리 있어요	편리해요
대각분	대각선
인정받게습니다	인정받게 되었습니다
써세요	쓰세요
두 두	두
풀 말해요	풀어볼까요
의는	의 경우는
은은	은
나어요	나타내요
분배법칙칙	분배법칙
해 돼요	해요
나쳐요	나눠요
것에요	것이에요
만들어 해요	만들어져요
구해 풀어볼게요	구해볼게요
판단하기는쳐요	판단하기는 어려워요
판단하기는습니다	판단하기는 어렵습니다
갖워요	가져요
받고 해요	받고 있어요
있는에요	있어요
지지보고	지 보고
세었,	세었네요
편리하니다	편리합니다
편리봐요	편리해요
그는 그는	그는
같은 같아요	같아요
나눈에요	나눠요